##############################################################################
#...###########...#
#....#########....#
#..#..#######..#..#
#..##..#####..##..#
#..###..###..###..#
#..####..#..####..#
#..#####...#####..#
#..#############..#
#..#############..#
#..#############..#
#..#############..#
#..#############..#
#..#############..#
#..#############..#
##############################################################################
