########################################
#.P.C....######........####.........####
#.####.#...####.######...####.###.######
#......###..#...#####.##......###......G
####.######.#########.######.###########
#####.#####.#########.##..##...#########
#####.......#####........#####.#########
###########.Y..#####.......##..#########
##############.#####..##.##...##########
###########....####..###.####.##########
##########..#######.####...#..##########
##########.###.#....###..####.##########
##########.###...#.##....####.##########
##########.....###....##.###...#########
##############.#########......##########
########################################
