##############################################################################
###P##########################################################################
###.#######################################..................................G
###.#######################################.##################################
###.#######################################.##################################
###.#######################################.##################################
###.#######################################.##################################
###.#######################################.##################################
###.#######################################.##################################
###.#######################################.##################################
###.....................................###.##################################
###.######################.################.##################################
###.######################.################.##################################
###........................################.##################################
###.#######################################.##################################
###.#######################################.##################################
###.#######################################.##################################
###.#######################################.##################################
###.........................................##################################
##############################################################################
