##############################################################################
#...P#.......####...############.............................................#
#.########.#.#.##.#.#.##....####.#.#####################.####.####.###########
#...#......#.#.##.###.##.##.####.#...###################.#.##.####.#.#####...G
###.#.######.#.##.###.##.....###.#.#.................#.#.#.#########.#####.###
#...#.##.....#........##.###.....#...#######.#######...#...................#.#
#.###.##.###.#.#########.#######.###.#######.###############################.#
#.....##.#...................................................................#
##############################################################################
